1111111111111111111111111111111111111111
10000000000000100000000000000000C0000001
10011111100000100111111000011111100000C1
1P001000000000100000001000000001000000C1
10001000111111111111001111111101111111C1
10001000100000000000001000000001000000C1
10001000100111111111111000011001000000C1
10001000100000000000000000011001000000C1
10000000100000000000000000011001000000C1
10011111111111100111111111111001000000C1
10000000000000100000000000000001000000C1
11111111111111111111111110000001000000E1
1111111111111111111111111111111111111111
